#########
#       #
#  #    #
#       #
#    #  #
#       #
#########