#############
#           #
#     #     #
#     #     #
#     #     #
### ##### ###
#     #     #
#     #     #
#           #
#     #     #
#     #     #
#     #     #
#############