###########
#    #    #
#         #
#    #    #
#   ###   #
#    #    #
#         #
#    #    #
###########